11111111111111111111111111111111
1..............3...............1
1..............................1
1...11........1111.........11..1
1..............................1
1.......2...........2..........1
1......111..............111....1
1......111.....2........111....1
1..............................1
1...11....................11...1
1............11...11...........1
1.....3.....111131111..........1
1............11...11...........1
1......111...............111...1
1......111......2........111...1
1..............................1
1.......................3......1
1....2.........1111............1
1.....1.....................1..1
1.....1.....................1..1
1.....11111.....3......111111..1
1.......................2......1
1.....2........................1
11111111111111111111111111111111
